"filename", "language", "C#", "comment", "blank", "total"
"c:\Programering\ShutTheDuckUpBreakOut\ShutTheDuckUpBreakOut\ShutTheDuckUpBreakOut\Assets\BossCamera.cs", "C#", 31, 1, 12, 44
"c:\Programering\ShutTheDuckUpBreakOut\ShutTheDuckUpBreakOut\ShutTheDuckUpBreakOut\Assets\Plugins\Demigiant\DOTween\Modules\DOTweenModuleAudio.cs", "C#", -98, -80, -25, -203
"c:\Programering\ShutTheDuckUpBreakOut\ShutTheDuckUpBreakOut\ShutTheDuckUpBreakOut\Assets\Plugins\Demigiant\DOTween\Modules\DOTweenModuleEPOOutline.cs", "C#", -109, -18, -20, -147
"c:\Programering\ShutTheDuckUpBreakOut\ShutTheDuckUpBreakOut\ShutTheDuckUpBreakOut\Assets\Plugins\Demigiant\DOTween\Modules\DOTweenModulePhysics.cs", "C#", -137, -60, -20, -217
"c:\Programering\ShutTheDuckUpBreakOut\ShutTheDuckUpBreakOut\ShutTheDuckUpBreakOut\Assets\Plugins\Demigiant\DOTween\Modules\DOTweenModulePhysics2D.cs", "C#", -125, -51, -18, -194
"c:\Programering\ShutTheDuckUpBreakOut\ShutTheDuckUpBreakOut\ShutTheDuckUpBreakOut\Assets\Plugins\Demigiant\DOTween\Modules\DOTweenModuleSprite.cs", "C#", -63, -17, -14, -94
"c:\Programering\ShutTheDuckUpBreakOut\ShutTheDuckUpBreakOut\ShutTheDuckUpBreakOut\Assets\Plugins\Demigiant\DOTween\Modules\DOTweenModuleUI.cs", "C#", -390, -203, -70, -663
"c:\Programering\ShutTheDuckUpBreakOut\ShutTheDuckUpBreakOut\ShutTheDuckUpBreakOut\Assets\Plugins\Demigiant\DOTween\Modules\DOTweenModuleUnityVersion.cs", "C#", -264, -99, -41, -404
"c:\Programering\ShutTheDuckUpBreakOut\ShutTheDuckUpBreakOut\ShutTheDuckUpBreakOut\Assets\Plugins\Demigiant\DOTween\Modules\DOTweenModuleUtils.cs", "C#", -123, -27, -18, -168
"c:\Programering\ShutTheDuckUpBreakOut\ShutTheDuckUpBreakOut\ShutTheDuckUpBreakOut\Assets\Prefab\Plugins\Demigiant\DOTween\Modules\DOTweenModuleAudio.cs", "C#", 98, 80, 25, 203
"c:\Programering\ShutTheDuckUpBreakOut\ShutTheDuckUpBreakOut\ShutTheDuckUpBreakOut\Assets\Prefab\Plugins\Demigiant\DOTween\Modules\DOTweenModuleEPOOutline.cs", "C#", 109, 18, 20, 147
"c:\Programering\ShutTheDuckUpBreakOut\ShutTheDuckUpBreakOut\ShutTheDuckUpBreakOut\Assets\Prefab\Plugins\Demigiant\DOTween\Modules\DOTweenModulePhysics.cs", "C#", 137, 60, 20, 217
"c:\Programering\ShutTheDuckUpBreakOut\ShutTheDuckUpBreakOut\ShutTheDuckUpBreakOut\Assets\Prefab\Plugins\Demigiant\DOTween\Modules\DOTweenModulePhysics2D.cs", "C#", 125, 51, 18, 194
"c:\Programering\ShutTheDuckUpBreakOut\ShutTheDuckUpBreakOut\ShutTheDuckUpBreakOut\Assets\Prefab\Plugins\Demigiant\DOTween\Modules\DOTweenModuleSprite.cs", "C#", 63, 17, 14, 94
"c:\Programering\ShutTheDuckUpBreakOut\ShutTheDuckUpBreakOut\ShutTheDuckUpBreakOut\Assets\Prefab\Plugins\Demigiant\DOTween\Modules\DOTweenModuleUI.cs", "C#", 390, 203, 70, 663
"c:\Programering\ShutTheDuckUpBreakOut\ShutTheDuckUpBreakOut\ShutTheDuckUpBreakOut\Assets\Prefab\Plugins\Demigiant\DOTween\Modules\DOTweenModuleUnityVersion.cs", "C#", 264, 99, 41, 404
"c:\Programering\ShutTheDuckUpBreakOut\ShutTheDuckUpBreakOut\ShutTheDuckUpBreakOut\Assets\Prefab\Plugins\Demigiant\DOTween\Modules\DOTweenModuleUtils.cs", "C#", 123, 27, 18, 168
"c:\Programering\ShutTheDuckUpBreakOut\ShutTheDuckUpBreakOut\ShutTheDuckUpBreakOut\Assets\Script\Bullet.cs", "C#", 1, 0, 1, 2
"c:\Programering\ShutTheDuckUpBreakOut\ShutTheDuckUpBreakOut\ShutTheDuckUpBreakOut\Assets\Script\DangeSignPopUp.cs", "C#", 0, 0, 4, 4
"c:\Programering\ShutTheDuckUpBreakOut\ShutTheDuckUpBreakOut\ShutTheDuckUpBreakOut\Assets\Script\Health.cs", "C#", 31, 0, 6, 37
"c:\Programering\ShutTheDuckUpBreakOut\ShutTheDuckUpBreakOut\ShutTheDuckUpBreakOut\Assets\Script\Items\Guns.cs", "C#", 0, 0, -1, -1
"c:\Programering\ShutTheDuckUpBreakOut\ShutTheDuckUpBreakOut\ShutTheDuckUpBreakOut\Assets\Script\Items\Item_Melee.cs", "C#", 1, 0, 1, 2
"c:\Programering\ShutTheDuckUpBreakOut\ShutTheDuckUpBreakOut\ShutTheDuckUpBreakOut\Assets\Script\Items\Objects_Weapons.cs", "C#", 7, 0, -4, 3
"c:\Programering\ShutTheDuckUpBreakOut\ShutTheDuckUpBreakOut\ShutTheDuckUpBreakOut\Assets\Script\Items\Weapon.cs", "C#", -4, 0, 4, 0
"c:\Programering\ShutTheDuckUpBreakOut\ShutTheDuckUpBreakOut\ShutTheDuckUpBreakOut\Assets\Script\Player\AimWithWeapon.cs", "C#", 5, 0, 0, 5
"c:\Programering\ShutTheDuckUpBreakOut\ShutTheDuckUpBreakOut\ShutTheDuckUpBreakOut\Assets\Script\Player\Player.cs", "C#", 3, 0, 1, 4
"c:\Programering\ShutTheDuckUpBreakOut\ShutTheDuckUpBreakOut\ShutTheDuckUpBreakOut\Assets\Script\Player\PlayerMovment.cs", "C#", 14, 0, 11, 25
"c:\Programering\ShutTheDuckUpBreakOut\ShutTheDuckUpBreakOut\ShutTheDuckUpBreakOut\Assets\Script\boss\BossHealingPot.cs", "C#", 17, 0, 6, 23
"c:\Programering\ShutTheDuckUpBreakOut\ShutTheDuckUpBreakOut\ShutTheDuckUpBreakOut\Assets\Script\boss\bossSystem.cs", "C#", 73, 1, 17, 91
"Total", "-", 179, 2, 58, 239