"filename", "language", "JSON", "C#", "Markdown", "comment", "blank", "total"
"c:\Programering\ShutTheDuckUpBreakOut\ShutTheDuckUpBreakOut\ShutTheDuckUpBreakOut\Assets\Plugins\Demigiant\DOTween\Modules\DOTweenModuleAudio.cs", "C#", 0, 98, 0, 80, 25, 203
"c:\Programering\ShutTheDuckUpBreakOut\ShutTheDuckUpBreakOut\ShutTheDuckUpBreakOut\Assets\Plugins\Demigiant\DOTween\Modules\DOTweenModuleEPOOutline.cs", "C#", 0, 109, 0, 18, 20, 147
"c:\Programering\ShutTheDuckUpBreakOut\ShutTheDuckUpBreakOut\ShutTheDuckUpBreakOut\Assets\Plugins\Demigiant\DOTween\Modules\DOTweenModulePhysics.cs", "C#", 0, 137, 0, 60, 20, 217
"c:\Programering\ShutTheDuckUpBreakOut\ShutTheDuckUpBreakOut\ShutTheDuckUpBreakOut\Assets\Plugins\Demigiant\DOTween\Modules\DOTweenModulePhysics2D.cs", "C#", 0, 125, 0, 51, 18, 194
"c:\Programering\ShutTheDuckUpBreakOut\ShutTheDuckUpBreakOut\ShutTheDuckUpBreakOut\Assets\Plugins\Demigiant\DOTween\Modules\DOTweenModuleSprite.cs", "C#", 0, 63, 0, 17, 14, 94
"c:\Programering\ShutTheDuckUpBreakOut\ShutTheDuckUpBreakOut\ShutTheDuckUpBreakOut\Assets\Plugins\Demigiant\DOTween\Modules\DOTweenModuleUI.cs", "C#", 0, 390, 0, 203, 70, 663
"c:\Programering\ShutTheDuckUpBreakOut\ShutTheDuckUpBreakOut\ShutTheDuckUpBreakOut\Assets\Plugins\Demigiant\DOTween\Modules\DOTweenModuleUnityVersion.cs", "C#", 0, 264, 0, 99, 41, 404
"c:\Programering\ShutTheDuckUpBreakOut\ShutTheDuckUpBreakOut\ShutTheDuckUpBreakOut\Assets\Plugins\Demigiant\DOTween\Modules\DOTweenModuleUtils.cs", "C#", 0, 123, 0, 27, 18, 168
"c:\Programering\ShutTheDuckUpBreakOut\ShutTheDuckUpBreakOut\ShutTheDuckUpBreakOut\Assets\Script\Guns.cs", "C#", 0, 101, 0, 6, 23, 130
"c:\Programering\ShutTheDuckUpBreakOut\ShutTheDuckUpBreakOut\ShutTheDuckUpBreakOut\Assets\Script\Health.cs", "C#", 0, 23, 0, 0, 5, 28
"c:\Programering\ShutTheDuckUpBreakOut\ShutTheDuckUpBreakOut\ShutTheDuckUpBreakOut\Assets\Script\Item_Gun.cs", "C#", 0, 41, 0, 10, 16, 67
"c:\Programering\ShutTheDuckUpBreakOut\ShutTheDuckUpBreakOut\ShutTheDuckUpBreakOut\Assets\Script\Item_Melee.cs", "C#", 0, 42, 0, 2, 9, 53
"c:\Programering\ShutTheDuckUpBreakOut\ShutTheDuckUpBreakOut\ShutTheDuckUpBreakOut\Assets\Script\Objects_Guns.cs", "C#", 0, 12, 0, 0, 5, 17
"c:\Programering\ShutTheDuckUpBreakOut\ShutTheDuckUpBreakOut\ShutTheDuckUpBreakOut\Assets\Script\Objects_Weapons.cs", "C#", 0, 13, 0, 0, 9, 22
"c:\Programering\ShutTheDuckUpBreakOut\ShutTheDuckUpBreakOut\ShutTheDuckUpBreakOut\Assets\Script\OldPlayer\AimWithGun.cs", "C#", 0, 28, 0, 0, 5, 33
"c:\Programering\ShutTheDuckUpBreakOut\ShutTheDuckUpBreakOut\ShutTheDuckUpBreakOut\Assets\Script\OldPlayer\AimWithWeapon.cs", "C#", 0, 42, 0, 0, 7, 49
"c:\Programering\ShutTheDuckUpBreakOut\ShutTheDuckUpBreakOut\ShutTheDuckUpBreakOut\Assets\Script\OldPlayer\Mouse.cs", "C#", 0, 17, 0, 0, 5, 22
"c:\Programering\ShutTheDuckUpBreakOut\ShutTheDuckUpBreakOut\ShutTheDuckUpBreakOut\Assets\Script\OldPlayer\Player.cs", "C#", 0, 41, 0, 2, 23, 66
"c:\Programering\ShutTheDuckUpBreakOut\ShutTheDuckUpBreakOut\ShutTheDuckUpBreakOut\Assets\Script\OldPlayer\PlayerMovment.cs", "C#", 0, 59, 0, 7, 16, 82
"c:\Programering\ShutTheDuckUpBreakOut\ShutTheDuckUpBreakOut\ShutTheDuckUpBreakOut\Assets\Script\OldPlayer\Weapon.cs", "C#", 0, 107, 0, 5, 23, 135
"c:\Programering\ShutTheDuckUpBreakOut\ShutTheDuckUpBreakOut\ShutTheDuckUpBreakOut\Assets\Script\ShowMousePos.cs", "C#", 0, 12, 0, 2, 5, 19
"c:\Programering\ShutTheDuckUpBreakOut\ShutTheDuckUpBreakOut\ShutTheDuckUpBreakOut\Assets\Script\UI_ChargeThrow.cs", "C#", 0, 17, 0, 2, 3, 22
"c:\Programering\ShutTheDuckUpBreakOut\ShutTheDuckUpBreakOut\ShutTheDuckUpBreakOut\Assets\Script\YoungPlayer\YoungMechanics.cs", "C#", 0, 129, 0, 16, 30, 175
"c:\Programering\ShutTheDuckUpBreakOut\ShutTheDuckUpBreakOut\ShutTheDuckUpBreakOut\Assets\Script\YoungPlayer\YoungMovment.cs", "C#", 0, 84, 0, 3, 14, 101
"c:\Programering\ShutTheDuckUpBreakOut\ShutTheDuckUpBreakOut\ShutTheDuckUpBreakOut\Packages\manifest.json", "JSON", 47, 0, 0, 0, 1, 48
"c:\Programering\ShutTheDuckUpBreakOut\ShutTheDuckUpBreakOut\ShutTheDuckUpBreakOut\Packages\packages-lock.json", "JSON", 529, 0, 0, 0, 1, 530
"c:\Programering\ShutTheDuckUpBreakOut\ShutTheDuckUpBreakOut\ShutTheDuckUpBreakOut\README.md", "Markdown", 0, 0, 1, 0, 0, 1
"Total", "-", 576, 2077, 1, 610, 426, 3690